5
10
red
n0n0n0n0n0
00w0w00000
a0w0w0z000
00w0l10000
00w0l10000
00w0l10000
00l3n00000
00n0w00000
00w0w00000
0000000000
